12 20
01 02 02 02 02 02 02 02 02 02 02 02 02 02 02 02 02 02 02 03
04 00 00 00 00 00 00 00 00 00 00 00 00 00 00 00 00 00 00 08
04 00 00 09 00 09 00 00 00 00 00 00 00 00 00 00 00 00 00 08
04 00 00 09 00 09 00 00 00 00 00 00 00 00 00 00 00 00 00 08
04 00 00 09 99 09 00 00 00 00 00 00 00 00 00 00 00 00 00 08
04 00 00 09 09 09 00 00 00 00 00 00 00 00 00 00 00 00 00 08
04 00 00 00 00 00 00 00 00 00 00 00 00 00 00 00 00 00 00 08
04 00 00 00 00 00 00 00 00 00 00 00 00 00 00 00 00 00 00 08
04 00 00 00 00 00 00 00 00 00 00 00 00 00 00 00 00 00 00 08
04 00 00 00 00 00 00 00 00 00 00 00 00 00 00 00 00 00 00 08
04 00 00 00 00 00 00 00 00 00 00 00 00 00 00 00 00 00 00 08
05 06 06 06 06 06 06 06 06 06 06 06 06 06 06 06 06 06 06 07