12 20
0	1	2	3	4	5	6	7	8	9	10	11	12	12	12	12	12	12	12	12
18	19	20	21	22	23	24	25	26	27	28	29	30	30	30	30	30	30	30	30
36	37	38	39	40	41	42	43	44	45	46	47	48	48	48	48	48	48	48	48
54	55	56	57	58	59	60	61	62	63	64	65	66	66	66	66	66	66	66	189
72	73	74	75	76	77	78	79	80	81	82	83	84	99	99	99	99	99	189	189
90	91	92	93	94	95	96	97	98	99	100	101	102	103	189	189	189	189	189	189
108	109	110	111	112	113	114	115	116	117	118	119	120	121	122	123	189	189	189	189
126	127	128	129	130	131	132	133	134	135	136	137	138	139	140	141	189	189	189	189
144	145	146	147	148	149	150	151	152	153	154	155	156	157	158	159	189	189	189	189
162	163	164	165	166	167	168	169	170	171	172	173	174	175	176	177	189	189	189	189
180	181	182	183	184	185	186	187	188	189	190	191	192	193	194	195	189	189	189	189
198	199	200	201	202	203	204	205	206	207	208	209	210	211	212	213	189	189	189	189